11111111111111
10000000000001
1110C000000001
10011100000001
10000000C00001
10000000111101
100P00111C0001
10C00000000001
11100000011111
1E111000111001
100000000C0001
11100000000001
10C00000000001
11111111111111