111111111111
1CA11E0P0001
11000B11C001
111111111111